Bobble.Net v1.0

[Level]
06,06,08,08,02,02,03,03
06,06,08,08,02,02,03,00
02,02,03,03,06,06,08,08
02,03,03,06,06,08,08,00

[Level]
00,08,08,08,06,06,06,00
08,00,00,00,00,00,06,00
00,08,00,00,00,00,06,00
08,02,03,07,02,03,06,00
00,03,07,02,03,07,02,00

[Level]
08,07,06,05,05,06,07,08
08,07,06,05,06,07,08,00
00,08,07,06,06,07,08,00
00,08,07,06,07,08,00,00
00,00,08,07,07,08,00,00
00,00,08,07,08,00,00,00
00,00,00,08,08,00,00,00
00,00,00,08,00,00,00,00

[Level]
04,04,03,00,00,03,04,04
04,04,03,00,03,04,04,00
00,00,04,04,04,04,00,00
00,00,04,03,04,00,00,00
00,00,04,03,03,04,00,00
00,00,04,04,04,00,00,00
00,00,00,03,03,00,00,00

[Level]
00,00,00,01,01,00,00,00
00,00,00,03,00,00,00,00
00,00,00,01,01,00,00,00
00,08,01,03,01,08,00,00
00,08,03,07,07,03,08,00
00,01,03,03,03,01,00,00
00,00,01,08,08,01,00,00

[Level]
06,01,05,02,04,03,04,02
03,06,01,05,02,04,03,04
04,03,06,01,05,02,04,03
03,04,03,06,01,05,02,04
04,03,04,03,06,01,05,02
02,04,03,04,03,06,01,05
05,02,04,03,04,03,06,01

[Level]
00,00,00,06,06,00,00,00
00,00,01,02,01,00,00,00
00,00,02,01,01,02,00,00
00,06,06,02,06,06,00,00
00,00,02,02,02,02,00,00
01,01,06,01,06,01,01,00
00,02,02,01,01,02,02,00

[Level]
00,00,00,01,01,00,00,00
03,02,03,02,03,02,03,00
02,00,00,00,00,00,00,02
03,01,03,01,03,01,03,00
01,00,00,00,00,00,00,01
03,05,03,05,03,05,03,00
05,00,00,00,00,00,00,05

[Level]
00,00,00,01,01,00,00,00
00,00,01,07,01,00,00,00
00,00,02,07,07,02,00,00
00,02,07,06,07,02,00,00
00,08,07,06,06,07,08,00
00,08,07,06,07,08,00,00
00,00,08,07,07,08,00,00
00,00,08,07,08,00,00,00
00,00,00,08,08,00,00,00

[Level]
00,02,00,02,00,02,00,00
02,01,02,01,02,01,02,00
00,02,00,02,00,02,00,00
00,06,00,06,00,06,00,00
06,04,06,04,06,04,06,00
00,06,00,06,00,06,00,00
00,03,00,03,00,03,00,00
03,08,03,08,03,08,03,00
00,03,00,03,00,03,00,00
